....###############################....
.......................................
.......................................
.......................................
.......................................
.......................................
..........#.........#####.#............
..........#...............#............
..........#...............#............
..........#...............#............
..........#...............#............
..........#...............#............
..........#.#.#.#.#.#.#.#.#............
.....##############################....
.......................................
.......................................
.......................................
.......................................
.......................................
.......................................
.......................................
.......................................
.......................................
.......................................
.......................................
.......................................
.......................................
.......................................
.......................................
.....##############################....
.......................................
.......................................
.......................................
.......................................
.......................................
.......................................
.......................................
.......................................
.......................................
.......................................